-12
13
-4
8
00000000000000000000000000
00000000000000000000000000
00000000000000000000000000
00000000000000000000000000
00000000000000000000000110
00000000000000000000000000
00000000000000011111110000
10000000000000011111110000
00000000000000011111110000
00000000000000011111110000
01000000000000011111110000
00000000000000011111110000
00000000000000000000000000
