-19
21
-9
11
00000000000000000000000000000000000000000
00111111111111111111111111111111111111110
00000000000000000000000000000000000000000
00000000000000000000000000000000000000000
00000000000000000000000000000000000000000
00000000000000000000000000000000000000000
00000000000000000000000000000000000000000
00000000000000000000000000000011000000000
00000000000000000000000000000000000000000
00000000000000000000001111111000000000000
00000001000000000000001111111000000000000
00000000000000000000001111111000000000000
00000000000000000000001111111000000000000
00000000100000000000001111111000000000000
00000000000000000000001111111000000000000
00000000000000000000000000000000000000000
00000000000000000000000000000000000000000
00000000000001111000000000000000000000000
00000000000000000000000000000000000000000
00000000000000000000000000000000000000000
00000000000000000000000000000000000000000
